AAAAAAFBFAAAAAA
AAAAAAFBFAAAAAA
CCCCCCFBFCCCCCC
AAAAAAFBFAAAAAA
AAAAAAFBFAAAAAA
AAAAAAFBFAAAAAA
FFFFFFDDDFFFFFF
CCCCCCEFECCCCCC
FFFFFFDDDFFFFFF
AAAAAAFBFAAAAAA
AAAAAAFBFAAAAAA
AAAAAAFBFAAAAAA
CCCCCCFBFCCCCCC
AAAAAAFBFAAAAAA
AAAAAAFBFAAAAAA
