0000000000000000
0000000000000000
0011221000211210
0000000000000000
0000103000301112
0000100000002000
0221103000301000
0000000000000000
0000000000000000
0000000000000000
0000103000301222
0000100000001000
0112103000301000
0000000000000000
0011111000111110
0000000000000000
