0000000000000000
0000000000000000
0000200010002000
0000000000000000
0001000202000100
0020000000000030
0000030020030000
0000020000020000
0000040030040000
0000020000020000
0000030020030000
0030000000000020
0001000202000100
0000000000000000
0000200010002000
0000000000000000
